111111111111111111111
100000000000000000001
101010111010101010101
100000000011000000001
101010111010101010101
100000000000100000001
101010111011101010101
100000000000100000001
101010101010101010101
100000000000000000001
101010101010101010101
100000000000000000001
101010101010101010101
100000000000000000001
101010101010101010101
100000000000000000001
101010101010101010101
100000000000000000001
101010101010101010101
100000000000000000001
111111111111111111111