11111111111
12222222221
10101010101
10000000001
10101010101
10000000001
10101010101
10000000001
10101010101
10000000001
11111111111